1111111111111111
100E00C000000C01
10C0001111000001
100111111100N001
1P00111000C00001
1000001000000001
1000111100000111
1111111111111111
