1111111111111111
100000C000000C01
10C0001111000001
100111111100N001
1P001110E0C00001
1000001000000001
1000111100000111
1111111111111111
