1111111111111111111111111111111
11000000000000N00C00011100000E1
1100000000000000000000000000C01
1P00C0001111C0000000000C0011111
1000000011111100000111000011111
1111111111111111111111111111111
