1111111111111111111111
1100000000000X00000001
1P00111E00C0000C000001
1111111111111111111111
